10 10
w w w w w w w w w w
w m m m m m m m w w
w m w m w m m m w w
w m w m w w w m w w
w m w m w m m m w w
w m w m m m m m m w
w m w m w w w w w w
w m w m m m m m m w
w p m m m m m m w w
w w w w w w w w w w