25 25
w w w w w w w w w w w w w w w w w w w w w w w w w
w a m m m m m m m m m m w m m m m m m m m m m b w
w m w w w m w w w m w m w m w m w w w m w w w m w
w m w m m m m m m m w m w m w m m m m m m m w m w
w m w m w w w m w w w m w m w w w m w w w m w m w
w m m m w m m m m m m m m m m m m m m m w m m m w
w m w m w m w w w w w m w m w w w w w m w m w m w
w m w m m m w m m m m m w m m m m m w m m m w m w
w m w m w m w m w w w w w w w w w m w m w m w m w
w m m m w m w m m m m m m m m m m m w m w m m m w
w m w w w m w m w w w w m w w w w m w m w w w m w
w m m m m m m m m m m w m w m m m m m m m m m m w
w w w w w m w w w w m m p m m w w w w m w w w w w
w m m m m m m m m m m w m w m m m m m m m m m m w
w m w w w m w m w w w w m w w w w m w m w w w m w
w m m m w m w m m m m m m m m m m m w m w m m m w
w m w m w m w m w w w w w w w w w m w m w m w m w
w m w m m m w m m m m m w m m m m m w m m m w m w
w m w m w m w w w w w m w m w w w w w m w m w m w
w m m m w m m m m m m m m m m m m m m m w m m m w
w m w m w w w m w w w m w m w w w m w w w m w m w
w m w m m m m m m m w m w m w m m m m m m m w m w
w m w w w m w w w m w m w m w m w w w m w w w m w
w c m m m m m m m m m m w m m m m m m m m m m d w
w w w w w w w w w w w w w w w w w w w w w w w w w
